00000000000000000000
00000000000000000000
00011111111111111000
00012222222222221000
00012243222224321000
00012243222224321000
00012243222224321000
00012243222224321000
00012222222222221000
00012243222224321000
00012243222224321000
00012243222224321000
00012243222224321000
00012222252222221000
00012442222244221000
00012332222233221000
00012222222222221000
00011111111111111000
00000000000000000000
00000000000000000000